### bitmap of permissions at the end of each classname, 1 = ADMIN, 2 = RESOURCE_DOMAIN_ADMIN, 4 = DOMAIN_ADMIN, 8 = USER
### Please standardize naming conventions to camel-case (even for acronyms).

### Account commands
createAccount=com.cloud.api.commands.CreateAccountCmd;3
deleteAccount=com.cloud.api.commands.DeleteAccountCmd;3
updateAccount=com.cloud.api.commands.UpdateAccountCmd;3
disableAccount=com.cloud.api.commands.DisableAccountCmd;7
enableAccount=com.cloud.api.commands.EnableAccountCmd;7
###lockAccount=com.cloud.api.commands.LockAccountCmd;7
listAccounts=com.cloud.api.commands.ListAccountsCmd;15

#### User commands
createUser=com.cloud.api.commands.CreateUserCmd;3
deleteUser=com.cloud.api.commands.DeleteUserCmd;3
updateUser=com.cloud.api.commands.UpdateUserCmd;3
listUsers=com.cloud.api.commands.ListUsersCmd;7
####lockUser=com.cloud.api.commands.LockUserCmd;7
disableUser=com.cloud.api.commands.DisableUserCmd;7
enableUser=com.cloud.api.commands.EnableUserCmd;7


#### Domain commands
createDomain=com.cloud.api.commands.CreateDomainCmd;1
updateDomain=com.cloud.api.commands.UpdateDomainCmd;1
deleteDomain=com.cloud.api.commands.DeleteDomainCmd;1
listDomains=com.cloud.api.commands.ListDomainsCmd;7
listDomainChildren=com.cloud.api.commands.ListDomainChildrenCmd;7

####Cloud Identifier commands
getCloudIdentifier=com.cloud.api.commands.GetCloudIdentifierCmd;15

#### Limit commands
updateResourceLimit=com.cloud.api.commands.UpdateResourceLimitCmd;7
updateResourceCount=com.cloud.api.commands.UpdateResourceCountCmd;7
listResourceLimits=com.cloud.api.commands.ListResourceLimitsCmd;15

#### VM commands
deployVirtualMachine=com.cloud.api.commands.DeployVMCmd;15
destroyVirtualMachine=com.cloud.api.commands.DestroyVMCmd;15
rebootVirtualMachine=com.cloud.api.commands.RebootVMCmd;15
startVirtualMachine=com.cloud.api.commands.StartVMCmd;15
stopVirtualMachine=com.cloud.api.commands.StopVMCmd;15
resetPasswordForVirtualMachine=com.cloud.api.commands.ResetVMPasswordCmd;15
changeServiceForVirtualMachine=com.cloud.api.commands.UpgradeVMCmd;15
updateVirtualMachine=com.cloud.api.commands.UpdateVMCmd;15
recoverVirtualMachine=com.cloud.api.commands.RecoverVMCmd;7
listVirtualMachines=com.cloud.api.commands.ListVMsCmd;15
getVMPassword=com.cloud.api.commands.GetVMPasswordCmd;15
migrateVirtualMachine=com.cloud.api.commands.MigrateVMCmd;1
moveVirtualMachine=com.cloud.api.commands.MoveUserVMCmd;15

#### snapshot commands
createSnapshot=com.cloud.api.commands.CreateSnapshotCmd;15
listSnapshots=com.cloud.api.commands.ListSnapshotsCmd;15
deleteSnapshot=com.cloud.api.commands.DeleteSnapshotCmd;15
createSnapshotPolicy=com.cloud.api.commands.CreateSnapshotPolicyCmd;15
deleteSnapshotPolicies=com.cloud.api.commands.DeleteSnapshotPoliciesCmd;15
listSnapshotPolicies=com.cloud.api.commands.ListSnapshotPoliciesCmd;15


#### template commands
createTemplate=com.cloud.api.commands.CreateTemplateCmd;15
registerTemplate=com.cloud.api.commands.RegisterTemplateCmd;15
updateTemplate=com.cloud.api.commands.UpdateTemplateCmd;15
copyTemplate=com.cloud.api.commands.CopyTemplateCmd;15
deleteTemplate=com.cloud.api.commands.DeleteTemplateCmd;15
listTemplates=com.cloud.api.commands.ListTemplatesCmd;15
updateTemplatePermissions=com.cloud.api.commands.UpdateTemplatePermissionsCmd;15
listTemplatePermissions=com.cloud.api.commands.ListTemplatePermissionsCmd;15
extractTemplate=com.cloud.api.commands.ExtractTemplateCmd;15
prepareTemplate=com.cloud.api.commands.PrepareTemplateCmd;1

#### iso commands
attachIso=com.cloud.api.commands.AttachIsoCmd;15
detachIso=com.cloud.api.commands.DetachIsoCmd;15
listIsos=com.cloud.api.commands.ListIsosCmd;15
registerIso=com.cloud.api.commands.RegisterIsoCmd;15
updateIso=com.cloud.api.commands.UpdateIsoCmd;15
deleteIso=com.cloud.api.commands.DeleteIsoCmd;15
copyIso=com.cloud.api.commands.CopyTemplateCmd;15
updateIsoPermissions=com.cloud.api.commands.UpdateIsoPermissionsCmd;15
listIsoPermissions=com.cloud.api.commands.ListIsoPermissionsCmd;15
extractIso=com.cloud.api.commands.ExtractIsoCmd;15

#### guest OS commands
listOsTypes=com.cloud.api.commands.ListGuestOsCmd;15
listOsCategories=com.cloud.api.commands.ListGuestOsCategoriesCmd;15

#### service offering commands
createServiceOffering=com.cloud.api.commands.CreateServiceOfferingCmd;1
deleteServiceOffering=com.cloud.api.commands.DeleteServiceOfferingCmd;1
updateServiceOffering=com.cloud.api.commands.UpdateServiceOfferingCmd;1
listServiceOfferings=com.cloud.api.commands.ListServiceOfferingsCmd;15

#### disk offering commands
createDiskOffering=com.cloud.api.commands.CreateDiskOfferingCmd;1
updateDiskOffering=com.cloud.api.commands.UpdateDiskOfferingCmd;1
deleteDiskOffering=com.cloud.api.commands.DeleteDiskOfferingCmd;1
listDiskOfferings=com.cloud.api.commands.ListDiskOfferingsCmd;15

#### vlan commands
createVlanIpRange=com.cloud.api.commands.CreateVlanIpRangeCmd;1
deleteVlanIpRange=com.cloud.api.commands.DeleteVlanIpRangeCmd;1
listVlanIpRanges=com.cloud.api.commands.ListVlanIpRangesCmd;1

#### address commands
associateIpAddress=com.cloud.api.commands.AssociateIPAddrCmd;15
disassociateIpAddress=com.cloud.api.commands.DisassociateIPAddrCmd;15
listPublicIpAddresses=com.cloud.api.commands.ListPublicIpAddressesCmd;15

#### firewall commands
listPortForwardingRules=com.cloud.api.commands.ListPortForwardingRulesCmd;15
createPortForwardingRule=com.cloud.api.commands.CreatePortForwardingRuleCmd;15
deletePortForwardingRule=com.cloud.api.commands.DeletePortForwardingRuleCmd;15
#### updatePortForwardingRule=com.cloud.api.commands.UpdatePortForwardingRuleCmd;15

#### NAT commands
enableStaticNat=com.cloud.api.commands.EnableStaticNatCmd;15
createIpForwardingRule=com.cloud.api.commands.CreateIpForwardingRuleCmd;15
deleteIpForwardingRule=com.cloud.api.commands.DeleteIpForwardingRuleCmd;15
listIpForwardingRules=com.cloud.api.commands.ListIpForwardingRulesCmd;15
disableStaticNat=com.cloud.api.commands.DisableStaticNatCmd;15

#### load balancer commands
createLoadBalancerRule=com.cloud.api.commands.CreateLoadBalancerRuleCmd;15
deleteLoadBalancerRule=com.cloud.api.commands.DeleteLoadBalancerRuleCmd;15
removeFromLoadBalancerRule=com.cloud.api.commands.RemoveFromLoadBalancerRuleCmd;15
assignToLoadBalancerRule=com.cloud.api.commands.AssignToLoadBalancerRuleCmd;15
listLoadBalancerRules=com.cloud.api.commands.ListLoadBalancerRulesCmd;15
listLoadBalancerRuleInstances=com.cloud.api.commands.ListLoadBalancerRuleInstancesCmd;15
updateLoadBalancerRule=com.cloud.api.commands.UpdateLoadBalancerRuleCmd;15

#### router commands
startRouter=com.cloud.api.commands.StartRouterCmd;7
rebootRouter=com.cloud.api.commands.RebootRouterCmd;7
stopRouter=com.cloud.api.commands.StopRouterCmd;7
destroyRouter=com.cloud.api.commands.DestroyRouterCmd;7
changeServiceForRouter=com.cloud.api.commands.UpgradeRouterCmd;7
listRouters=com.cloud.api.commands.ListRoutersCmd;7

#### system vm commands
startSystemVm=com.cloud.api.commands.StartSystemVMCmd;1
rebootSystemVm=com.cloud.api.commands.RebootSystemVmCmd;1
stopSystemVm=com.cloud.api.commands.StopSystemVmCmd;1
destroySystemVm=com.cloud.api.commands.DestroySystemVmCmd;1
listSystemVms=com.cloud.api.commands.ListSystemVMsCmd;3
migrateSystemVm=com.cloud.api.commands.MigrateSystemVMCmd;1

#### configuration commands
updateConfiguration=com.cloud.api.commands.UpdateCfgCmd;1
listConfigurations=com.cloud.api.commands.ListCfgsByCmd;1
createConfiguration=com.cloud.api.commands.CreateCfgCmd;1
listCapabilities=com.cloud.api.commands.ListCapabilitiesCmd;15

#### pod commands
createPod=com.cloud.api.commands.CreatePodCmd;1
updatePod=com.cloud.api.commands.UpdatePodCmd;1
deletePod=com.cloud.api.commands.DeletePodCmd;1
listPods=com.cloud.api.commands.ListPodsByCmd;3

#### zone commands
createZone=com.cloud.api.commands.CreateZoneCmd;1
updateZone=com.cloud.api.commands.UpdateZoneCmd;1
deleteZone=com.cloud.api.commands.DeleteZoneCmd;1
listZones=com.cloud.api.commands.ListZonesByCmd;15

#### events commands
listEvents=com.cloud.api.commands.ListEventsCmd;15
listEventTypes=com.cloud.api.commands.ListEventTypesCmd;15

#### alerts commands
listAlerts=com.cloud.api.commands.ListAlertsCmd;3

#### system capacity commands
listCapacity=com.cloud.api.commands.ListCapacityCmd;3
listCapacityByType=com.cloud.api.commands.ListCapacityByTypeCmd;3

#### host commands
addHost=com.cloud.api.commands.AddHostCmd;3
addCluster=com.cloud.api.commands.AddClusterCmd;1
deleteCluster=com.cloud.api.commands.DeleteClusterCmd;1
updateCluster=com.cloud.api.commands.UpdateClusterCmd;1
reconnectHost=com.cloud.api.commands.ReconnectHostCmd;1
updateHost=com.cloud.api.commands.UpdateHostCmd;1
deleteHost=com.cloud.api.commands.DeleteHostCmd;3
prepareHostForMaintenance=com.cloud.api.commands.PrepareForMaintenanceCmd;1
cancelHostMaintenance=com.cloud.api.commands.CancelMaintenanceCmd;1
listHosts=com.cloud.api.commands.ListHostsCmd;3
addSecondaryStorage=com.cloud.api.commands.AddSecondaryStorageCmd;1
updateHostPassword=com.cloud.api.commands.UpdateHostPasswordCmd;1

#### volume commands
attachVolume=com.cloud.api.commands.AttachVolumeCmd;15
detachVolume=com.cloud.api.commands.DetachVolumeCmd;15
createVolume=com.cloud.api.commands.CreateVolumeCmd;15
deleteVolume=com.cloud.api.commands.DeleteVolumeCmd;15
listVolumes=com.cloud.api.commands.ListVolumesCmd;15
extractVolume=com.cloud.api.commands.ExtractVolumeCmd;15

#### registration command:  FIXME -- this really should be something in management server that
####                                 generates a new key for the user and they just have to
####                                 use that key...the key is stored in the db associated w/
####                                 the userId...every request to the developer API should be
####                                 checked against the key
registerUserKeys=com.cloud.api.commands.RegisterCmd;1

### async-query command
queryAsyncJobResult=com.cloud.api.commands.QueryAsyncJobResultCmd;15
listAsyncJobs=com.cloud.api.commands.ListAsyncJobsCmd;15

#### storage pools commands
listStoragePools=com.cloud.api.commands.ListStoragePoolsCmd;3
createStoragePool=com.cloud.api.commands.CreateStoragePoolCmd;1
#### updateStoragePool=com.cloud.api.commands.UpdateStoragePoolCmd;1
deleteStoragePool=com.cloud.api.commands.DeletePoolCmd;1
listClusters=com.cloud.api.commands.ListClustersCmd;3
enableStorageMaintenance=com.cloud.api.commands.PreparePrimaryStorageForMaintenanceCmd;1
cancelStorageMaintenance=com.cloud.api.commands.CancelPrimaryStorageMaintenanceCmd;1

#### security group commands
createSecurityGroup=com.cloud.api.commands.CreateSecurityGroupCmd;15
deleteSecurityGroup=com.cloud.api.commands.DeleteSecurityGroupCmd;15
authorizeSecurityGroupIngress=com.cloud.api.commands.AuthorizeSecurityGroupIngressCmd;15
revokeSecurityGroupIngress=com.cloud.api.commands.RevokeSecurityGroupIngressCmd;15
authorizeSecurityGroupEgress=com.cloud.api.commands.AuthorizeSecurityGroupEgressCmd;15
revokeSecurityGroupEgress=com.cloud.api.commands.RevokeSecurityGroupEgressCmd;15
listSecurityGroups=com.cloud.api.commands.ListSecurityGroupsCmd;15

#### vm group commands
createInstanceGroup=com.cloud.api.commands.CreateVMGroupCmd;15
deleteInstanceGroup=com.cloud.api.commands.DeleteVMGroupCmd;15
updateInstanceGroup=com.cloud.api.commands.UpdateVMGroupCmd;15
listInstanceGroups=com.cloud.api.commands.ListVMGroupsCmd;15

### Certificate commands
uploadCustomCertificate=com.cloud.api.commands.UploadCustomCertificateCmd;1

### other commands
listHypervisors=com.cloud.api.commands.ListHypervisorsCmd;15

### VPN
createRemoteAccessVpn=com.cloud.api.commands.CreateRemoteAccessVpnCmd;15
deleteRemoteAccessVpn=com.cloud.api.commands.DeleteRemoteAccessVpnCmd;15
listRemoteAccessVpns=com.cloud.api.commands.ListRemoteAccessVpnsCmd;15

addVpnUser=com.cloud.api.commands.AddVpnUserCmd;15
removeVpnUser=com.cloud.api.commands.RemoveVpnUserCmd;15
listVpnUsers=com.cloud.api.commands.ListVpnUsersCmd;15

#### network offering commands
createNetworkOffering=com.cloud.api.commands.CreateNetworkOfferingCmd;1
updateNetworkOffering=com.cloud.api.commands.UpdateNetworkOfferingCmd;1
#### deleteNetworkOffering=com.cloud.api.commands.DeleteNetworkOfferingCmd;1
listNetworkOfferings=com.cloud.api.commands.ListNetworkOfferingsCmd;15

#### network commands
createNetwork=com.cloud.api.commands.CreateNetworkCmd;15
deleteNetwork=com.cloud.api.commands.DeleteNetworkCmd;15
listNetworks=com.cloud.api.commands.ListNetworksCmd;15
restartNetwork=com.cloud.api.commands.RestartNetworkCmd;15
updateNetwork=com.cloud.api.commands.UpdateNetworkCmd;15

#### SSH key pair commands
registerSSHKeyPair=com.cloud.api.commands.RegisterSSHKeyPairCmd;15
createSSHKeyPair=com.cloud.api.commands.CreateSSHKeyPairCmd;15
deleteSSHKeyPair=com.cloud.api.commands.DeleteSSHKeyPairCmd;15
listSSHKeyPairs=com.cloud.api.commands.ListSSHKeyPairsCmd;15

#### Projects commands
createProject=com.cloud.api.commands.CreateProjectCmd;15
deleteProject=com.cloud.api.commands.DeleteProjectCmd;15
updateProject=com.cloud.api.commands.UpdateProjectCmd;15
activateProject=com.cloud.api.commands.ActivateProjectCmd;15
suspendProject=com.cloud.api.commands.SuspendProjectCmd;15
listProjects=com.cloud.api.commands.ListProjectsCmd;15
addAccountToProject=com.cloud.api.commands.AddAccountToProjectCmd;15
deleteAccountFromProject=com.cloud.api.commands.DeleteAccountFromProjectCmd;15
listProjectAccounts=com.cloud.api.commands.ListProjectAccountsCmd;15
listProjectInvitations=com.cloud.api.commands.ListProjectInvitationsCmd;15

joinProject=com.cloud.api.commands.JoinProjectCmd;15

#### 
createFirewallRule=com.cloud.api.commands.CreateFirewallRuleCmd;15
deleteFirewallRule=com.cloud.api.commands.DeleteFirewallRuleCmd;15
listFirewallRules=com.cloud.api.commands.ListFirewallRulesCmd;15

#### hypervisor capabilities commands
updateHypervisorCapabilities=com.cloud.api.commands.UpdateHypervisorCapabilitiesCmd;1
listHypervisorCapabilities=com.cloud.api.commands.ListHypervisorCapabilitiesCmd;1
